%%%%%%%%%%
%%  %%%%%%
%%   %%%%%
%      G%%
%%%%%%%%%%
%%%%. .%%%
%%%%   %%%
%G    . %%
%%%%% .  %
%%%%%%% .%
%%%%%%% P%
%%%%%%%%%%
