%%%%%%%%%%
%% .%%%%%%
%%   %%%%%
% . .  G%%
%%   %%%%%
%% .   %%%
%%%%   %%%
%G  . . %%
%%%%% .  %
%%%%%%% .%
%%%%%%% P%
%%%%%%%%%%
